NO ./resources/wall_new_03.xpm
SO ./resources/wall_new_02.xpm
WE ./resources/wall_new_01.xpm
EA ./resources/wall_new_04.xpm

F 2,219,17
C 66,102,245

1111111111111111111111111111111111111111111111111111111
1000000000000000000000001000001000000000000000000000001
1000000000000000000000001000001000000000000000000000001
1000000B00000000B0000000100000D00000B000000000B00000001
1000000000000000000000001000001000000000000000000000001
100000000000000000000000D000001000000000000000000000001
1000000B00000000B00000001000001000000000000000B00000001
1000000000000000000000001000001000000000000000000000001
1000000000000000000000001000001000000000000000000000001
1111111111111111111111111000001111111111111111111111111
1000000000000000000000000000000000000000000000000000001
100000000000000000000000000S000000000000000000000000001
111111111111111111111111100000111111111111111111111D111
1000000000000000000000001000001000000000000000000000001
1000000000000000000000001000001000000000000000000000001
10000000000000000000000010000010000000000B0000000000001
1000000000000000000000001000001000000000000000000000001
1000000000000000000000001000001000000000000000B00000001
1000000000000000000000001000001000000000000000000000001
1000000000000000000000001000001000000000000000000000001
1B0000000000000000000000D0000010000000000B0000000000001
1111111111111111111111111111111111111111111111111111111