NO ./resources/surprise.xpm
SO ./resources/wall_02.xpm
WE ./resources/wall_03.xpm
EA ./resources/wall_04.xpm

F 2,219,17
C 66,102,245

111111111111111111
1E00B0000000000111
100000000000000111
10B000000010000001
111111111011111111
100000000000000001
100000000000000001
10000000000B000001
111111111111111111