
NO ./resources/wall_new_03.xpm
SO ./resources/wall_new_02.xpm
WE ./resources/wall_new_01.xpm
EA ./resources/wall_new_04.xpm

F 220,255,255
C 0,255,255

        1111111111111111111111111
        1000000000110000000000001
        1011000001110000000000001
        1001000000000000000000001
111111111011000001110000000000001
100000000011000001110111111111111
11110111111111011100000010001
11110111011111011101010010001
110N0000110101011100000010001
10000000000000001100000010001
10000000000000001101010010001
1100000111010101111101111000111
11110111 1110101 101111010001
11111111 1111111 111111111111

