NO ./resources/wall_new_03.xpm
SO ./resources/wall_new_02.xpm
WE ./resources/wall_new_01.xpm
EA ./resources/wall_new_04.xpm

F 2,219,17
C 66,102,245


111111111111111111
100000000100000001
1000N00001000E0001
100000000100000001
111111111111111111
         1
         1
         1
         1
111111111111111111
100000000100000001
1000S00001000W0001
100000000100000001
111111111111111111