NO ./resources/wall_01.xpm
SO ./resources/wall_02.xpm
WE ./resources/wall_03.xpm
EA ./resources/wall_04.xpm

F 2,219,17
C 66,102,245

11111111111
10000000011
1000N10001
1000001111
1111111111
