NO ./resources/wall_01.xpm
SO ./resources/wall_02.xpm
WE ./resources/wall_03.xpm
EA ./resources/wall_04.xpm

F 220,100,0
C 225,30,0

11111111111
10000000011
1000N10001
1000001111
1111111111
