NO ./resources/surprise.xpm
SO ./resources/wall_02.xpm
WE ./resources/wall_03.xpm
EA ./resources/wall_04.xpm

F 2,219,17
C 66,102,245

111111111111111111
100000000000000011
1000N1000000000001
100000000000001111
111111111111111
