NO ./resources/wall_01.xpm
SO ./resources/wall_02.xpm
WE ./resources/wall_03.xpm
EA ./resources/wall_04.xpm

F 220,100,0
C 225,30,0

1111111111111111111111111111111
1000000000000000000000000000001
1000W00000000000000001000000001
1000001111111111111111111111111
1111111