NO ./resources/wall_new_03.xpm
SO ./resources/wall_new_02.xpm
WE ./resources/wall_new_01.xpm
EA ./resources/wall_new_04.xpm

F 2,219,17
C 66,102,245

11111111111111111111111111111111
10000000000000000000000000000001
1000N100000000000000000000000001
10000000000000111000000000000001
11111111111111111111111111111111
100000000000000001
100000000000000001
100000000000000001
111111111111111111