NO ./resources/surprise.xpm
SO ./resources/wall_02.xpm
WE ./resources/wall_03.xpm
EA ./resources/wall_04.xpm

F 2,219,17
C 66,102,245

1111111111111111111111111111111
1000B000000000000000000000000001
1000N100000000B00000000000000001
10B00000000000111000000000000001
111111111D1111111111111111111111
100000000000000001
100000000000000001
10000000000B000001
111111111111111111