NO ./resources/wall_01.xpm
SO ./resources/wall_02.xpm
WE ./resources/wall_03.xpm
EA ./resources/wall_04.xpm

F 2,219,17
C 66,102,245

111111111111111111
1000B0000000000011
1000N100000000B001
10B000000000001111
111111111111111
